1 ContributorNew Music Friday 06/02/23 LyricsBizarrap - Peso Pluma: Bzrp Music Sessions, Vol. 55
The Weeknd - Popular (with Playboi Carti & Madonna)
Toosii & 21 Savage - Pull Up
KAROL G - WATATI (feat. Aldo Ranks)
Metro Boomin, Swae Lee & NAV - Calling (Spider-Man: Across the Spider-Verse)
Foo Fighters - The Glass
Gunna - bread & butter
Moneybagg Yo - Keep It Low (feat. Future)
Dave - Sprinter
Tove Lo - I like u
Madison Beer - Home To Another One
Burna Boy - Sittin' On Top Of The World
Dom Dolla - Eat Your Man (with Nelly Furtado)
Ed Sheeran - A Beautiful Game
Jelly Roll - Halfway To Hell
Machine Gun Kelly - PRESSURE
French Montana - I Can't Lie (with Kodak Black)
The Chainsmokers - Self Destruction Mode
Daddy Yankee - BEACHY
Kid Cudi - PORSCHE TOPLESS
Fridayy & Chris Brown - Don't Give It Away
Ty Dolla $ign - Motion
Martin Garrix - Hurrican–µ
Stray Kids - S-Class
Lauv - Steal The Show - From "Elem–µntal"
Sam Fischer & Meghan Trainor - Alright
Gabriels - Gloryüïí
PHABO - Stay
Beach Fossils - Sleeping On My Own
Bully - All I Do
Tainy - FANTASMA | AVC
Alesso - Without You
Kelly Clarkson - i hate love (feat. Steve Martin)
Corey Kent - Once or Twice
Dylan Scott - This Town's Been Too Good To Us
Jon Batiste - Be Who You Are (Real Magic)
Dominic Fike - Mona Lisa
Peter McPoland - Turn Off The Noise
Avenged Sevenfold - Game Over
Bring Me The Horizon - AmEN!
Ti√´sto - Yesterday
San Holo & AURORA - BRING BACK THE COLOR
LUCKI - NO BAP
SoFaygo - WISH I COULD TELL YOU
No Guidnce - Is It A Crime?
Mad Tsai - Billie Jean - Spotify Singles
Katelyn Tarver - Starting to Scare Me
Khloe Rose - The Other POV
Blonde Redhead - Snowman
Aidan Bissett - Bloom
Jub√´l - Triple A (feat. NLE Choppa)
HUGEL - Es un secreto (feat. Pensi√≥n & Juanmih)
LIT killah - Los del Espacio
Becky G - The Fire Inside (From The Original Motion Picture "Flamin' Hot")
Mura Masa - Drugs
Bloc Party - Keep It Rolling
CKay - nwayi
Boj - Soak Garri
Helena Deland - Spring Bug
The Aces - Attention
Lauren Alaina - A Walk In The Bar
CIL - Leave
Cian Ducrot - Heaven
grentperez - Stuck On You
Los Aptos & Cuco - Miel
Nathaniel Rateliff & The Night Sweats - Slow Pace Of Time (Feat. Charlie Gabriel)
Chris Renzema - God & Prozac
Purr - Who Is Afraid Of Blue
NEIL FRANCES - Head Straight
Roy Woods - Don't Mind Me
Alicia Creti - Strange
Devon Cole - 1-800-GOT-STRESS
The Revivalists - Good Old Daysüïí
Drew Parker - I'll Love You Longer
Warren Zeiders - Tell Me Like It Is
Ben Harper - Masterpiece
Alex Porat - Hopelessly Devoted To You - Spotify Single
grandma - Painless
Braden Bales - PICK ME UP
corook - tiny little titties
Tigercub - Show Me My Maker
lovelytheband - i'm sorry
Sam Feldt - House For Kings
Dorian Electra - Sodom & Gomorrah
Sky Rompiendo - El Cielo
Rhea Raj - Gimme More - Spotify Singles
Full Crate - Sinking Ship
Bennett Coast - Bender
Tanya Tucker - Breakfast In Birmingham 
Colter Wall - Corralling the Blues
Rancid - New American
Saba & NO ID - hue_man nature
TuKool Tiff - Overflowüêö
Mozzy - 10 Percentüïí
Kenny Mason - DRACULA
CHIKA - Requiem For A Dream
Sid Sriram - Dear Sahanaüïí
Big Time Rush - Superstitious
Cisco Swank - Changes (feat. Laura Elliott)
Kidsnot$aints. - BurnEmbed