1 ContributorNew Music Friday 05/12/23 LyricsLil Durk - All My Life (feat. J. Cole)
Jonas Brothers - Summer Baby
Shakira - Acr√≥stico
Lauren Daigle - These Are The Days
Thirty Seconds To Mars - Stuck
CHASE B - Ring Ring (feat. Travis Scott, Don Toliver, Quavo & Ty Dolla $ign)
BTS - The Planet
Remi Wolf - Prescription
Bailey Zimmerman - You Don‚Äôt Want That Smoke
Ed Sheeran - Life Goes On (feat. Luke Combs)
YoungBoy Never Broke Again - I Heard
Janelle Mon√°e - Lipstick Lover
Victoria Mon√©t - Party Girls (feat. Buju Banton)
Noah Kahan - If We Were Vampires (feat. Wesley Schultz) - Spotify Singles
Parker McCollum - Burn It Down
Laufey - From The Start
Lovejoy - Portrait of a Blank Slate
Daft Punk - Infinity Repeating (2013 Demo) [feat. Julian Casablancas+The Voidz]
Overmono - Cold Blooded
Becky Hill - Side Effects
aespa - Spicy
Sebastian Yatra - VAGABUNDO
Lil Tecca - Need Me
Jorja Smith - Little Things
Arlo Parks - Pegasus (ft. Phoebe Bridgers)
A Boogie Wit da Hoodie - MVP (feat. G-Eazy)
Kiana Led√© - Deeper
James Arthur - A Year Ago
Sam Hunt - Women In My Life
Eyedress - Escape From The Killer 2008
Alex Porat - I'm Not Crying
TWICE - Hare Hare
J Balvin - Toretto
Queens of the Stone Age - Emotion Sickness
Dolly Parton - World On Fire
Grupo Marca Registrada - Me Haces Tan Bien
Charlotte Cardin - Looping
Jeremy Zucker - OK
Nothing But Thieves - Overcome
BABY GRAVY - Goodness Gracious
G Flip - Be Your Man
Cloudy June - 21st Century Princess
Hailey Knox - Charismatic
Tyla - Girl Next Door
Christine and the Queens - Tears can be so soft
LP Giobbi - Feels Just Like it
MEDUZA - Friends
Groupthink - Dressed For A Funeralüïí
Joyner Lucas - What's That?
Russ - Perfectionist
Alok - 2 Much 2 Handle
James Hype - Lose Control
Joel Corry - Dance Around It
Two Friends - More Than Yesterday (feat. Russell Dickerson)
Jamie Miller - Maybe Next Time
Krooked Kings - Wish We Could Be Friends
Yoke Lore ‚Äì Winona
Sarah Kinsley - Lovegod
Wande - Wild & Free
ERNEST - Takes After You
Rosa Linn - Hallelujah
Killer Mike - MOTHERLESS - Single Version
The South Hill Experiment - DREAMS!
Josh Levi - SEE LOW
A R I Z O N A - Graveyard
Bryce Vine - The Kids Aren't Alright
Kembe X - The Basement
DD Osama - Be Alright
Tay Iwar - Undercover Lover
Rhea Raj - Atmosphere
Pink Sweat$ - Run Through Fire
KayCyy - ROLL THE DICE (Prod. Gesaffelstein)
Cochise - KANEKI
Monaleo - Ass Kickin'
Maiya The Don - Keep It Cute
Shaggy - Whine & Jumping (feat. Patrice Roberts)üêö
veggi ‚Äì AFRAIDüêö
Emotional Oranges - Not Worthy
Alemeda - UR SO FULL OF IT
Madison McFerrin - Runüêö
Local Natives - NYE
The Warning - MORE
little image - RUNWAY
Lori McKenna - Killing Me (feat. Hillary Lindsey)
The Young Escape - You Shine
Will Paquin - Drown
Albert Hammond Jr - Old Man
Bishop Briggs - Baggage
Kah-Lo - fund$üêö
Deante' Hitchcock - Zodiac (feat. Shamba)
Jay Worthy & Roc Marciano - Wake Up‚òëÔ∏è
Layton Greene - Spin Again
Blaqbonez - Cinderella Girl (Where You Dey) [feat. Ludacris]
Rob Moose - Wasted (feat. Phoebe Bridgers)
Parker Millsap - Magic
KAIRO - Savior
Softee - Grief
LP - Golden
PISSKISS - carole king
Asking Alexandria - Dark VoidEmbed