2 ContributorsNew Music Friday 12/02/22 LyricsMetro Boomin - Creepin' (with The Weeknd & 21 Savage)
Lewis Capaldi - Pointless
Arcangel - La Jumpa
PinkPantheress - Boy's a liar
A$AP Rocky - Shittin' Me
Pheelz - Ballin
Villano Antillano - KaleidoscÃ³pica
100 gecs - Torture Me (feat. Skrillex)
Latto - FTCU (feat. GloRilla & Gangsta Boo)
Morgan Wallen - One Thing At A Time
Jessie Murph - Drunk in the Bathtub
Nas - One Mic, One Gun
$uicideboy$ - My Swisher Sweet, But My Sig Sauer
RM - Still Life (with Anderson .Paak)
Quinn XCII - Let Me Down (with Chelsea Cutler)
Noah Cyrus - Set For Life
PNAU - You Know What I Need
Bad Gyal - Real G
Metallica - Lux Ã†terna
NEIL FRANCES - HighğŸš
Stephen Dawes - It Could Be Me
Parker McCollum - Stoned
MOUNT WESTMORE - Activated
Coi Leray - Players
Joy Oladokun - Power
James Arthur - Heartbeat
Katie Gregson-MacLeod - white lies
brakence - 5g
Snakehips - Solitude (with BIA & Lucky Daye)
Cruza - Fantasy
halfâ€¢alive - Nobody
RINI - Pressure
SkyeChristy - I'm Not Like Alice
Lyn Lapid - Saturn
Jelly Roll - she
Loud Luxury - Afterparty
Finesse2tymes - Overdose
2Rare - Lil Mama
Precious Pepala - Voices
Julia Wolf - Gothic Babe Tendencies (feat. blackbear)
Felly - me and my gang
SASH - biscayne
Louis The Child - Amsterdam (Deep Inside) - Single VersionğŸš
ITZY - Cheshire
Olivia Knox - Smoke SignalğŸš
Emotional Oranges - Let Me Go
Lil Peep - angeldust
Nippa - The One
Babyface Ray - Wonderful Wayne & Jackie Boy (feat. Lil Durk)
Justus Bennetts - Everything Is Nothing
Carlie Hanson - Pretender
Lainey Wilson - New Friends
Aya Nakamura - SMS
Powfu - shade of blue (feat. Rxseboy, Tia Tia & Shalfi)
OHGEESY - Gallery
Lil Mosey - Backpack
Yandel - Delincuente
Nakkia Gold - Past
Two Friends - Hate Me (feat. Billy Lockett)
Chloe George - Sunny D
Emei - Backtrack
Against The Current - blindfolded
Icewear Vezzo - One Time (feat. Jeezy)â˜‘ï¸
Saucy Santana - Bop Bop
Russ Millions - One of a Kind
Jordan Hawkins - Screamin'ğŸš
THEY. - Set Me Free
LU KALA - Pretty Girl Era
Circa Waves - Carry You Home
Wallice - Japan
Jonah Kagen - georgia
Peach Tree Rascals - I Need ThatğŸš
Tenille Arts - Motel On the Moon
amy michelle - patience
Christian Kuria - Santorini
Yungeen Ace - Gang Nem (feat. EST Gee)â˜‘ï¸
Sheck Wes - PAIN!
Carl Cox - Deep Space X ğŸš
RL Grime - Renegade
Hunter Daily - Skeleton Key
Alex Warren - Chasing Shadows
will hyde - 6am in amsterdam.
Baby Fisher - This is the EndğŸš
hey, nothing - Too Drunk to Driveâ˜‘ï¸
lozeak - Cutthroat
moony - machinesğŸš
Ivan Cornejo - Ya Te PerdÃ­
AÃ¡yanna - Risky
David Dunn - PoisonğŸš
Rileyy Lanez - On Us
Laci Kaye Booth - Damn Good in a Dive BarğŸš
Ellise - Did It Hurt?
Ellye Lennon - PriorityğŸš
Blair Lee - Last BiteğŸš
Day Wave - Cold Like Me
Daniel Allan - Minuteman (with DLG.)ğŸš
Kieran Ivy - Figured Out
Teenage Priest - Let It PassğŸš
Grabbitz - When You & Me Dance
Adeem the Artist - CarolinaEmbed