1 ContributorNew Music Friday 03/03/23 LyricsMorgan Wallen - Dying Man
Nicki Minaj - Red Ruby Da Sleeze
Marshmello - El Merengue
Kali Uchis - Fantasy (feat. Don Toliver)
boygenius - Not Strong Enough
Mimi Webb - Freezing
j-hope - on the street (with J. Cole)
Don Toliver - Embarrassed (feat. Travis Scott)
Arlo Parks - Impurities
John Summit - Where You Are
6LACK - Since I Have A Lover
Morgan Wallen - Thinkin' Bout Me
slowthai - Sooner
Macklemore - NO BAD DAYS (feat. Collett)
Chiiild - I Hope I Packed A Parachute (feat. Charlotte Cardin)
YoungBoy Never Broke Again - Next
Demi Lovato - Still Alive
JAWNY - lalala
Ruеl - I DON'T WANNA BE LIKE YOU
Masego - What You Wanna Try
Young Nudy - Peaches & Eggplants (fеat. 21 Savage)
Anuel AA - Más Rica Que Ayer
BIA - SIXTEEN
Ashnikko - Worms
Benson Boone - Sugar Sweet
Ingrid Andress - Runnin (with JP Saxe)
Mckenna Grace - Buzzkill Baby
Portugal. The Man - Dummy
ILLENIUM - Insanity
Larry June - 89 Earthquake
Destroy Lonely - if looks could kill
Gorillaz - Captain Chicken (feat. Del The Funky Homosapien)
Eliza Rose - Better Love
Sigala - Feels This Good
Shygirl - Heaven (feat. Tinashe)
Beach Weather - Pineapple Sunrise
Maldy - Tiempos de Plan B
Dreamville - Ogogoro (with Bas & Ayra Starr)
Jordan Ward - FAMJAM4000
Dijon - coogie
Youth Lagoon - Idaho Alien
jxdn - Friends With Benefits
Jax - Cinderella Snapped
Steve Aoki - Hungry Heart ft. Hayley Kiyoko
ACRAZE - Take Me Away
Metallica - If Darkness Had a Son
grandson - Eulogy
The Dare - Good Time
Gus Dapperton - Horizons
Peach PRC - F U Goodbye
EMELINE - feelings
SG5 - Firetruck
Dimitri Vegas & Like Mike - Mexico
De La Soul - Me Myself and I
Wiz Khalifa - Don't Text Don't Call
Connor Price - Swing
TIMØ - Conquistar El Planeta
RMR - Crazy
Drayton Farley - Devil's in NOLA
Gabito Ballesteros - Ya Corazón
Tyler Braden - Wrong Right Now
Birdy - Raincatchers
Carlie Hanson - LSE to LAX
Cafuné - Perspective
Daisy Jones & The Six - Let Me Down Easy
Suki Waterhouse - To Love
SkyeChristy - Beach Zombies
Pecos & the Rooftops - 5AM
The Panhandlers - Tough Country
hey, nothing - Like a Brother
Kierra Sheard - What Matters (feat. Mali Music)
Anna Graves - Easy For You
James Vickery - Only You
Musiq Soulchild - i remember you my ex
Lojay - IYD
Real Boston Richey - Trapping & Finessing (LOVE Song)
Austin Millz - Inhale / Exhale
Jess Bays – Colourblind
Major Lazer - Designer
Bankrol Hayden - Bop Slide (feat. Blueface, OHGEESY & Maxo Kream)
Finesse2tymes - How to Act
Maiya The Don - Dusties
binki - Hotel Window
Slow Pulp - Cramps
Mo Lowda & the Humble - All Good Fun
WanMor – Certified
Young Miko - Lisa
Conway the Machine - Metallic 5's
Mike Dimes - HEAVY METAL
Frost Children - ALL I GOT
Jimi Somewhere - Baby from Atlanta
Royel Otis - Sofa King
Adi Oasis - Naked Feat. Leven Kali
Weston Estate - Where Do We Go?
Alana Springsteen - shoulder to cry on
Jana Horn - The Dream
Taylor Janzen - Nightmare
Ella Vos - Superglue
Samuel ASH - El AfterEmbed