1 ContributorNew Music Friday 05/26/23 LyricsLil Durk - War Bout It (feat. 21 Savage)
Dua Lipa - Dance The Night
Peso Pluma - Bye
Beyonc√© & Kendrick Lamar - AMERICA HAS A PROBLEM
d4vd - The Bridge
Taylor Swift - Karma (Remix) (feat. Ice Spice)
Kodak Black - Gunsmoke Town
Yeat & Young Thug - My wrist
Arlo Parks - Devotion
OneRepublic - RUNAWAY
Dominic Fike - Ant Pile
Swedish House Mafia - See The Light (feat. Fridayy)
Don Omar & Chencho Corleone - Podemos Repetirlo
Moneybagg Yo - Ocean Spray
Khamari - These Four Walls
Foo Fighters - Show Me How
Lil Durk - Stand By Me (feat. Morgan Wallen)
Lauren Spenc–µr Smith - That Part
Emei - Irresponsible
Kungs ‚Äì Shadows (f–µat. Carlita)
GloRilla - Lick Or Sum
Diddy, City Girls & Fabolous - Act Bad
ENHYPEN - Bite Me
Jessie Murph - Cowboys And Angels
Brian Kelley - See You Next Summer
Yng Lvcas & Justin Quiles ‚Äì Wazap
Tame Impala - Retina Show - Unreleased Demo
Logic - Juice II
Sleepy Hallow - Pain Talk (feat. Lil Tjay)
Cautious Clay & Joshua Karpeh - Ohio
Surfaces - Real Estate
Chenayder - Save U
Hayley Kiyoko - Greenlight
Johnny Orlando & Ali Gatie - When I'm Gone
Ozuna & Amarion - Tucu
Roosevelt - Ordinary Love
Dylan & Harry, Party Favor & Baauer - Thinkin of You
Chris Stussy - All Night Long üêö
Royal Blood - Mountains At Midnight
Towa Bird - Boomerang
Lola Young - Revolve Around You
Maisie Peters - Two Weeks Ago
Miya Folick - Shortstop
ERNEST & 49 Winchester - Night Life
Jackson Dean & Josh Ross - Girl from the North Country
Cat Burns - you don't love me anymore
Kevin Ross - Cocoa
Lauren Jauregui & Russ - Wolves (feat. Ty Dolla $ign)
Portugal. The Man - Summer of Luv (feat. Unknown Mortal Orchestra)
Jungle - Dominoes üêö
Sof√≠a Reyes & Danna Paola - tqum
James Fortune & Waka Flocka Flame - Voyage üêö
Bruno Major - Columbo
Sondae - Elohim
$NOT - Easter Pink
EST Gee - Turn The Streets Up
Big Boss Vette - Ion Need
Royal & the Serpent - ONE NATION UNDERDOGS
Matchbox Twenty - Queen of New York City
X Ambassadors, Teddy Swims & Jac Ross - Happy People
Jake Owen - On The Boat Again
Louis Tomlinson - High In California
ROSIE - Potential
thuy - butterflies (feat. Rexx Life Raj)
piri & Tommy Villiers - nice 2 me
Jam City - Touch Me (feat. Clara La San & Aidan)
Bathe Alone - In Your Wake
Slim, Faith Evans & Eric Bellinger - Gotta Have Faith
Cochise - HE HE
J Hus - It's Crazy
David Guetta & MORTEN - Lost In The Rhythm
The Voidz - Prophecy of the Dragon
Noah Pope - Shining
Kate Peytavin - something's off
Audrey Mika - satuRday
Noah Floersch - Thompson's Station
Buck Meek - Haunted Mountain
Brothers Osborne - Goodbye‚Äôs Kickin‚Äô In
James Barker Band - On The Water (feat. Dalton Dover)
Christian Nodal - Cazzualidades
BLK ODYSSY & KIRBY - YOU GOTTA MAN
Real Boston Richey - My Image
Monaleo - Goddess (feat. Flo Milli)
Asake ‚Äì Amapiano (feat. Olamide) ‚òëÔ∏è
Love Spells - Over and Over
KayCyy ‚Äì TIMELESS
Kari Faux & Gangsta Boo - WHITE CAPRICE
Jack Kays - THAT SUCKS!
Arden Jones - can't be my friend
Kevin Morby - Triumph
Portraits Of Tracy - Found!
Angelo De Augustine - The Ballad of Betty and Barney Hill
Conner Smith - How It Looks From Here
Trousdale - If You're Hurting
Graham Riley - Front Porch
Byron Messia - 90z ‚òëÔ∏è
Ben Reilly - Edna (Capes) ‚òëÔ∏è
Nonso Amadi & BEAM - Kilimanjaro ‚òëÔ∏è
Alborosie - Nah Sell Out (feat. Kabaka Pyramid) üêöEmbed