2 ContributorsNew Music Friday 03/17/23 LyricsLuke Combs - 5 Leaf Clover
100 gecs - Dumbest Girl Alive
Manuel Turizo - Triste
GloRilla - Don't Know (GloRidaz Bonus)
Melanie Martinez - DEATH
Lana Del Rey - The Grants
Taylor Swift - All Of The Girls You Loved Before
Hozier - Eat Your Young
Sabrina Carpenter - Feather
Eladio Carrion, Quavo & Rich The Kid, (feat. Ñengo Flow) - Peso a Peso
Kx5, deadmau5, Kaskade, AR/CO - Bright Lights
Fred again.., Skrillex, Four Tet - Baby again..
Doechii, Kodak Black - What It Is (Block Boy)
Lewis Capaldi - How I'm Feeling Now
Unknown Mortal Orchestra - Meshuggah
venbee - gutter
Yves Tumor - Parody
JVKE - this is what losing someone feels likе
Usher - GLU
Feid - REMIX EXCLUSIVO
Jimin - Set Mе Free Pt.2
Ni'jah, Childish Gambino, KIRBY - Sticky
Bailey Zimmerman - Religiously
Joy Oladokun, Noah Kahan - We’re All Gonna Die
EST Gee - BALL LIKE ME TOO
Nothing But Thieves - Welcome to the DCC
Gryffin - Dreams
M83 - Laura
ELENA ROSE - El Hombre
Alex Vaughn, Muni Long - IYKYK
Ryan Beatty - Ribbons
Tori Kelly - missin u
Matchbox Twenty - Wild Dogs (Running in a Slow Dream)
All Time Low - Calm Down
Lil Mosey - Flu Game
6LACK - Fatal Attraction
Aluna, TSHA - Killing Me
Saint Harison - TMF
Isabel Pless - Little Life
Chino Pacas, Fuerza Regida - Dijeron Que No La Iba Lograr
Bakar - Pit stop
Luh Tyler - A Day In The NOYA (feat. Loe Shimmy)
Tash Sultana - James Dean
Bedroom - Better Friends
Shania Twain - Falling - Spotify Singles
Elley Duhé, Teddy Swims - FACE MYSELF
The Chemical Brothers - No Reason
JPEGMAFIA & Danny Brown - Lean Beef Patty
Russ - NASTY
U2 - Invisible - Songs Of Surrender
Kamal. - white wine
ODESZA, Claud - To Be Yours
Amaarae - Reckless & Sweet
KB - EZ
Lauv - Talking To Myself - demo
Lil Keed (feat. Young Thug) - All I Wanna Know
KYLE - Movin'
Regard & Ella Henderson - No Sleep
Princess Nokia - closure
Jenna Raine - Stupid Cupid
Morgan Evans - On My Own Again
Aly & AJ - Blue Dress
Luke Grimes - Oh Ohio
Josiah and the Bonnevilles - Tennessee Song
Justin Quiles, NATTI NATASHA, Omar Courtz - En Bajita
Imanbek, Baby B3ns - Sunglasses
Snakehips- Show Me The Money
Natalie Jane - seeing you with other girls
NMIXX - Young, Dumb, Stupid
Charlotte Sands - Six Feet Under
CIL - Girl I Used To Be
Ali Gatie - Seasonal Love
Greyson Chance - Herringbone
Azekel - Chocolati ft. Nao
Desiigner, A Boogie Wit da Hoodie - PMR
03 Greedo - Bacc Like I Never Left
Avenged Sevenfold - Nobody
FIDLAR - On Drugs
Gretel Hänlyn - King of Nothing
Walker Hayes - if father time had a daughter
Seaforth - I Can't Take You Anywhere
Purple Tears, Swae Lee - Work It Out
WESTSIDE BOOGIE - Mood
Rory, reggie, Jay Electronica - Enough
Francis Mercier, Black Uhuru - Welcome To Dinna
BLK ODYSSY, Bootsy Collins - Honeysuckle Neckbone
Sam Feldt, Jonas Blue, Endless Summer, Violet Days - Crying On The Dancefloor
Curren$y, Jermaine Dupri - Essence Fest
Próxima Parada - So Many Ways to Get Downtown
Rich Amiri - Mention
Kota the Friend, Statik Selektah - One Life
Jastin Martin - Growing Pains
Curtis Waters - HIMBO
Peter Manos - Talk to Me
Tinariwen, Fats Kaplin - Tenere Den
Qing Madi - Why
No Guidnce - Lie To Me
heylog - update failed
Azzecca - Ego DeathEmbed